R 1920 1080
NO ./path_to_the_north_texture
SO ./path_to_the_south_texture
WE ./path_to_the_west_texture
EA ./path_to_the_east_texture

S ./path_to_the_sprite_texture
F 220,100,0
C 225,30,0

        111111111          11111111    111111111111111
       100000000011       10000000011110000000000000001
      10000000000001 11111000000000000000000000000000001
    11100000000000001000000000000000000001000000000000001
   100000000000010100000001000000000000001000000000000001
    10000000000000000010000000000000000000000000000000001
    10000000000000000010000000000000000000000000000000001
    100000010000000000000000000000010000000000000000000011
    1000000110000000000000000001001100000000000000000000001
    1001001  1000000000001000001000000000000000000000000001
    100011   100000000000010000100000000000000100000001011
     101 1111100000000000000001110000000000000000000001101
  11 100100001000000000000000000000000000000000000000000001
 1001000000001000000000011000000000010000000000000001000101
 1000010000000000000000100000000000010000000000000000111101
 1000010000000010000000000000000000000000000000000000001101
10000000101100000000000001000000000000000000000000100010001
1000000000110000000000000000000000000000000000000110000001
1000000000110000000000000000000000000000000000000000000001
 100000000100000000200020000000000000000000000000000010001
  11000010000000000000000000000000000000021000000000011111
   10000000000000000000000000000000000000000100000001 10001
   100000000000000000000000000000000000000000000000001100001         1                         1
  1000000001100000000000000000000000000000000000100000000001      11101                      11011111  1
   10000000010000000000000000000000000000000000011000000011  1111100001                     1000000001101     11
   100000001110000000000000000000000000000000000110000001   10000000001                     100000000000011111001 11
  1100000000010000000011000000000010000000000000000000101   100010000001                     101000000110000000011001
 100000000000100000111 1010100000000000000000000000000101  10001120000011 11                  11000000110000110000001
100000000011000100001  1100000000000000000000000011000001  100001000001001001                  1000000011100110000001
100000000011000000001 100001100000000000000000111 110111   100001100000000001                   111100001 10110000001
 10100000100000000001  100010000000000010000001  10001     1000011000000000001                 1110000001  1 100000001
  1100000101100000001 10001100000100010000000011100011     100001 110000000001                1000000001     100000001
    11001100000010001  11000000011010000000100001000101    1000001110000000001               10000011001     1010000001
     101  110010000101101110000011010000000100100000001     10000000000000000111            10000001 11     11000000011111
      1    101100100000001 11001 1001000000010111111101     100000000000000000001          10000011        1000000000000001
          1101000100000011 1000011000000000000001    1       1000000000000000000011        1001001        10000110000001001
         1000000001000000011000010020001000000001           100001000000000000000001        10001          11101000000011001
          1111000000000000010000001110001110000011          100010000000000000000000111     10001             11000000010001
            11000000000000010000011000001 100000001          1000000000000001000000000011   10001              1000000000101
           100000000000000100000000000001 100000001           1000000000000000000000000101 1 1001             10000000001 1
           10000000000000010110000000000110000000001           11000000000000001111000000110110001            1000000001
           1000000000000001000000000000010000000101             100000000000001    1101000001 1001            1000000001
          10000000000000000000000000000110000001101            100010000000001     10000100111 1001 1        1001100001
         1102000000000000000000000000000001110000001           100010000000001   111011100000011000101       1100000001
        100000000000000000000100000000000001200000011         10000000000001001 100001 100001000000001      100000000001
        1010000000000000011001001100000001000000000101 11     1000000000011111110000001000000001000001       1000000001
        100000000000000000100000000000001 1100000000001001 1110000000000000000000000011000000001100001      10010000001
        10000000000000000000100000000001  11001000000000011001001100000000100100000000000000000110011      100000000001
         1000000000000000000101011020000110000111000000111100000010000000000000000000000000000011001        11000000001
        1000000100000000000000000001110000000000100000000000000011000101110011100000000001000001 11      11   10000000011 1
         10000110000000000000000000110000000000000000000011110101000011 110000000000020111000001        100111101000000101011
         100000110010000000000000000000000000000000000000011 1 1100E0111000200000000011   11111        10000000000100000010001
        100000000111200000020000000000000000011000000000001011110000000000000000000001                10000000000000000000001
         10000000010000000000010000000000000000000200000000010011000000110100100000001            11  10000000000000000000001
         1000000000000000000000000000000000000000000000000001001 100001000000100010001         111001  1001000000000000000001
          11100000100000000000000000000000000000001100000000000110000000000110000000001       1001001 10001100000000000000101
             1000111000000001000000000000000000000000000000000010000000001100000000001       10000001 100000010100000000000011 11
             10001000111100000011000000000000000000100000000000000000000011000000000001      1000000011001000111010001000000001001
             10001111 100001111 10010111000000000000000000000000000000000000000000000001     100000000111100001 110000000000010001
           111001    110011      1110000000000101000000000000000000000000000020000000001   111100000001 1110011 111002000000000001
          1000011   100001        1000000000100010000000000000000000000200100000000000001 10000000000011000000010000000000000000001
         110001001  1000001        1000000000011 1000000000000000000000000000000000000011 10000000000000000000000000000000000100001
        1000000001111000001         10000000001  100000000000100000000000000000000000010011000000000100000000111110000000000010001
         111111100000000001         10000020001  1011000000000000000000000000000000000000110000000000000001001  100000001000000001
               101000000001         1000000000011101 110001000000000000000010011200000000001000000000000000001  101000001000000101
                110000000001        10011111001100001 1011 110000000000100010000000000000101000000000000000001  100000200100011001
                  1100000001         11    1000101001  1    10000000000000110010000000000000000000000000000001   1100000001100001
                  1001000101              100011001001   1   10000000000001100200000000000010000000000000000001    1000000010000111
                  10000000001             100000000011 1101 100000000000001 1010000000000000000000000000000001     10000000000000001
                   111110111           1 111001100000010000100000000000111   110100000000001000000000000000001      1000000000000001
                        1        1111110100000100001000000000000000000001   11111101100000000000000000000000001    10000000000000001
                                1000000000111011001100000000000000000000011100010000001000111000000000000010001     11111000000000001
                                1000100110110110001 10000000000000000000000000010100001000110000000000000010001         100001000011
                              111101101  1 1000000011111110000000000000000000011010001 100000000000000000000001          10011000001
                             1000001101   1000000000000110000001100000000000000001111  10000000000000000000011          1001100000001
                             10110010001   100001100000000001001100000000000110001    1000000001101010000000001         100100000011
                             1001000001    100001100001100111001100000000000011011    1000000000001011000000001          1110001001
                             1100000000111110001  1111 101   1000000000000000000001   101110101110001 100000001             111101
                            1000000000000000001         1    100000000000000000001    10110111111101   100000011                1
                           110000111000000011011        1     1000200000100000011     10000001000001  10001001001           1
                          1000001  10000000000001      1011   10000000001111001       100000010000001  10000000001 11     1101
                         1100001    1000000000001     100001  1000000001   1001       101100010200001 1100010001001001   100001
                        1000011      1110000000001   1100001111000001001  11001        1 100000000001100011 1000000001 11000111
                        100001         10000100000111010000000000000101  100001           1111101111 100001  1011000011000001001
                         11001         10001100011000000000000001011101  11111                 1     10001   101 100001100000001
                         100011       10000001001100000000000000111110011011                          111     1  10000000000001
                          100001       10000000000000000000000000000001 10001                                     11110000000001
                           11001       10000000000000000000000000000000110001                                        100000000001
                            101        10000000000000000000000000000000000001                                         110100002001
                           1001        1000000000000000000000000000111000011                                  1         1100000001
                            101     11100000010000000000000000000000100001                                   101         100010001
                            1011   1000000000000000000000000100000000000011                                 11011         11000001
                            100011110000000000000000000000000000000010000001                            1111000001       11100111
                            101000010000000000000000000000001010000010000001                           100000100001     1000001
                             1100000000000000000020000000001 1101000100000001                          100211100001     1000001
                               100001000000000000000000000011 1010011011000001                         10001110001      1000001
                               10100100000000011000000000000010000011011000001                         1000100001        100001
                               10001100010100000200000000001000000011001000001111                      1001 1011   11   110001
                                11001011111000010000000000010000000000000000000001                 11111001 1001111001 100001
                                  10001100011000001000000000100001100001000001101                1100000001  100000001110001
                                  10000000000010000000000000001001100010000000001               1000011101  10000000000100001
                             11  1000000000000001000000000000000010000000000000001              10001   1    1000000000000001
                            1001 10000002000000011111100000000010000000000000000011            110001        100001000000001
                           100001 1000000000001011  10010100110000000000000000000001          1001101         100100000000001
                          10000001 1100000000010001  1000101100011000100000000000001        110000001          11100000000001
                          10000001110000000100000001 1001101100010000000000000001001       1000100001         102000200000001  1
                           100010100000000000000000011100100000020001000000001100001       110011111         1101000000000001 101
                           1000000000000000000000010000001100000011000000000000000001     100101            100000000000000001001
                            100000000010000000000001000001100001000000000000000000001  1 1000101   111     1000000000000000000001
                            10000000000000000000000000000000001100020000000000000001  10110000011110001    1000000000010000000001
                        11111000000000000020000000001111000001111110000000000000011  110000111100000101 1 100000000000000000000001
                       100000000001000000000000000001   100000000110000000000000001 1000111   100000001101000000000000000010101101
                      100010000010000000000000000001    100000000000000100000000001 10101     1000000010000000000000000001 1100001
                      10000000000011000000111000001     100000000000000000000000101 10001     1000000000000000000000000001   1011
                       11110000000101000001 1000001      1101000000010011000000001  10001  1110000000100000000000000000001    1
                        1000000001100000001  1011001      1000110000000100000010011  1101110000111000011000011100000000001
                       10000011111000000001   112001       100000000011 110111 10001  100001001  101001 11001 110000000001
                      1000001     100000001    1000111      10201000001   1   100001   1110001   10001   1001100011001111
                       11111       10011001     1100001     1011101011        100001     1001     1001    11 10000101
                                  1000000101     101001     101 1011           10001      11       11        100010001
                                  10000000001   10000001    101  1              1001                          10000001
                                   10000001001  10000001   1001                 101                           1000001
                                   10001100001  110011001 1 10111                1                             11111
                                    111  11001 1010010001101000001
                                          1000110000010001010000001
                                           101  1000001101000001101
                                            1   1000000000020001101
                                                1010000000000000001
                                                1000000000001100001
                                                1000000000011100001
                                                 101000000000000001
                                                  1 110010011000001
                                                      1110000011101
                                                         10001   1
                                                          101
                                                           1






