R 640 480
NO ./img/redbrick.xpm
SO ./img/bluestone.xpm
WE ./img/redbrick.xpm
EA ./img/redbrick.xpm

S ./path_to_the_sprite_texture
F 220,100,0
C 135,206,235

1111111111
1E00000001
1000000001
1000000001
1000000001
1000000001
1000000001
1000000001
1000000001
1000000001
1000000001
1000000001
1000000001
1000000001
1000000001
1000000001
1000000001
1111111111
