R 1920 1080
NO ./tests/text/bluestone.xpm
SO ./tests/text/colorstone.xpm
WE ./tests/text/redbrick.xpm
EA ./tests/text/greystone.xpm

S ./tests/text/ghost.xpm
F 220,100,0
C 225,30,0

111111111111111111111111
1000000010W01000000000011
10002000000010000000000011
10000000111110000000000011
10000000000200000000000001
10000000000000000000000011
11111111111111111111111111