R 1920 1080
NO ./tests/text/bluestone.xpm
SO ./tests/text/colorstone.xpm
WE ./tests/text/redbrick.xpm
EA ./tests/text/greystone.xpm

S ./tests/text/ghost.xpm
F 220,100,0
C 225,30,0

11111
11111
101101
1000001
120E021
10010001
1111111