R 1920 1080
NO ./tests/text/bluestone.xpm
SO ./tests/text/colorstone.xpm
WE ./tests/text/redbrick.xpm
EA ./tests/text/greystone.xpm

S ./tests/text/lol.xpm
F 220,100,0
C 225,30,0

111111111111111111111111
10000000001W1000000000001
10002000000100000000000001
1000000000000000000000001
10000000000200000000000001
1000000000000000000000001
111111111111111111111111